5       7
0       6
2       1
4
2       3
3       2
4       3
4       4
